24
011111111111111111111111
000000000000000000000001
011111111111111011111101
011111100000001011111101
011111101111111011100001
000000000000000011101011
110111101101111011101011
110111101101000011101011
110111101101111111101011
110111101101111111101011
110111101100000000001011
110000001101111111111011
111101111100000000001011
111101111111111111101000
111100000000000000001110
111111111111111111111110